111111111111111111111111111111111
111111C11111111111111111111111111
1111111111111111E1111111111111111
1111111111C1111111111111111111111
1111111111111111111111111P1111111
100000000000000000000000000000001
100000000000000000000000000000001
111111111111111111111111111111111
